1111111111111
100000C000001
1P0011E000C01
1111111111111