1111111111111
1001C000000C1
1CC00111010C1
100011E000001
1111111111111