1111111111111
1C01000000001
1000000C000001
10C0000000001
1000011111001
10P0110E00001
1111111111011