1111111111111
100100C000001
1000011111001
10C001C0000C1
1000000C00001
10000C0000001
100000000C001
1000011111001
10C0110000001
100011000C001
1000110000001
10010000000C1
1000011111001
1P0011E000C01
1111111111111